Detector,Profile,File,Threshold,Score,TP,TN,FP,FN,Total_Count
expose,standard,artificialNoAnomaly/art_flatline.csv,0.9757623691126358,0.0,0,3428,0,0,3428
expose,standard,artificialNoAnomaly/art_daily_no_noise.csv,0.9757623691126358,0.0,0,3428,0,0,3428
expose,standard,artificialNoAnomaly/art_daily_small_noise.csv,0.9757623691126358,0.0,0,3428,0,0,3428
expose,standard,artificialNoAnomaly/art_noisy.csv,0.9757623691126358,0.0,0,3428,0,0,3428
expose,standard,artificialNoAnomaly/art_daily_perfect_square_wave.csv,0.9757623691126358,0.0,0,3428,0,0,3428
expose,standard,realKnownCause/nyc_taxi.csv,0.9757623691126358,-5.0,0,8535,0,1035,9570
expose,standard,realKnownCause/cpu_utilization_asg_misconfiguration.csv,0.9757623691126358,-1.9955132590935116,2,15774,27,1497,17300
expose,standard,realKnownCause/rogue_agent_key_hold.csv,0.9757623691126358,-2.0,0,1410,0,190,1600
expose,standard,realKnownCause/ec2_request_latency_system_failure.csv,0.9757623691126358,0.7264420743313258,5,3080,2,341,3428
expose,standard,realKnownCause/rogue_agent_key_updown.csv,0.9757623691126358,-0.48368768156010733,2,4021,14,528,4565
expose,standard,realKnownCause/ambient_temperature_system_failure.csv,0.9757623691126358,-2.0,0,5791,0,726,6517
expose,standard,realKnownCause/machine_temperature_system_failure.csv,0.9757623691126358,-3.107314814142598,3,19658,19,2265,21945
expose,standard,realTraffic/TravelTime_387.csv,0.9757623691126358,-3.0,0,1876,0,249,2125
expose,standard,realTraffic/speed_t4013.csv,0.9757623691126358,1.228860004072716,4,1864,7,246,2121
expose,standard,realTraffic/speed_6005.csv,0.9757623691126358,-1.0,0,1886,0,239,2125
expose,standard,realTraffic/TravelTime_451.csv,0.9757623691126358,-1.0,0,1621,0,217,1838
expose,standard,realTraffic/occupancy_6005.csv,0.9757623691126358,-1.11,0,1783,1,239,2023
expose,standard,realTraffic/speed_7578.csv,0.9757623691126358,-0.4040042106361186,2,840,2,114,958
expose,standard,realTraffic/occupancy_t4013.csv,0.9757623691126358,1.3792605576544466,2,1872,3,248,2125
expose,standard,realTweets/Twitter_volume_CRM.csv,0.9757623691126358,-1.5849152733670926,3,13537,22,1590,15152
expose,standard,realTweets/Twitter_volume_AAPL.csv,0.9757623691126358,-4.0,0,13564,0,1588,15152
expose,standard,realTweets/Twitter_volume_IBM.csv,0.9757623691126358,-1.870969078745322,5,13523,30,1585,15143
expose,standard,realTweets/Twitter_volume_CVS.csv,0.9757623691126358,0.3095610212036122,3,13572,5,1523,15103
expose,standard,realTweets/Twitter_volume_GOOG.csv,0.9757623691126358,-1.0810921719166646,2,13652,8,1430,15092
expose,standard,realTweets/Twitter_volume_UPS.csv,0.9757623691126358,-2.2342821034557,11,13474,57,1574,15116
expose,standard,realTweets/Twitter_volume_KO.csv,0.9757623691126358,-4.103037227476163,2,13494,20,1585,15101
expose,standard,realTweets/Twitter_volume_FB.csv,0.9757623691126358,-0.5833809947081758,2,13497,4,1580,15083
expose,standard,realTweets/Twitter_volume_AMZN.csv,0.9757623691126358,-4.0,0,13501,0,1580,15081
expose,standard,realTweets/Twitter_volume_PFE.csv,0.9757623691126358,-0.7948223569593124,3,13505,15,1585,15108
expose,standard,realAdExchange/exchange-2_cpm_results.csv,0.9757623691126358,-2.0,0,1219,0,162,1381
expose,standard,realAdExchange/exchange-3_cpm_results.csv,0.9757623691126358,-1.0,0,1155,0,153,1308
expose,standard,realAdExchange/exchange-3_cpc_results.csv,0.9757623691126358,-3.0,0,1155,0,153,1308
expose,standard,realAdExchange/exchange-4_cpm_results.csv,0.9757623691126358,-0.3735264248766823,3,1232,1,161,1397
expose,standard,realAdExchange/exchange-2_cpc_results.csv,0.9757623691126358,-1.0,0,1218,0,163,1381
expose,standard,realAdExchange/exchange-4_cpc_results.csv,0.9757623691126358,-3.0,0,1232,0,165,1397
expose,standard,artificialWithAnomaly/art_daily_jumpsup.csv,0.9757623691126358,0.7840111034582655,2,3024,1,401,3428
expose,standard,artificialWithAnomaly/art_daily_jumpsdown.csv,0.9757623691126358,0.7906424524853889,2,3024,1,401,3428
expose,standard,artificialWithAnomaly/art_daily_flatmiddle.csv,0.9757623691126358,0.47616066436014626,1,3020,5,402,3428
expose,standard,artificialWithAnomaly/art_increase_spike_density.csv,0.9757623691126358,-1.0,0,3025,0,403,3428
expose,standard,artificialWithAnomaly/art_load_balancer_spikes.csv,0.9757623691126358,-1.0,0,3025,0,403,3428
expose,standard,artificialWithAnomaly/art_daily_nojump.csv,0.9757623691126358,-1.213191301317563,0,3022,3,403,3428
expose,standard,realAWSCloudwatch/ec2_network_in_257a54.csv,0.9757623691126358,-1.0,0,3025,0,403,3428
expose,standard,realAWSCloudwatch/ec2_cpu_utilization_24ae8d.csv,0.9757623691126358,-2.0,0,3026,0,402,3428
expose,standard,realAWSCloudwatch/iio_us-east-1_i-a2eb1cd9_NetworkIn.csv,0.9757623691126358,-2.0,0,931,0,126,1057
expose,standard,realAWSCloudwatch/ec2_network_in_5abac7.csv,0.9757623691126358,0.018516348017524997,8,3530,17,466,4021
expose,standard,realAWSCloudwatch/ec2_cpu_utilization_ac20cd.csv,0.9757623691126358,0.7673127770158185,2,3024,1,401,3428
expose,standard,realAWSCloudwatch/rds_cpu_utilization_cc0c53.csv,0.9757623691126358,-0.14198431716872828,2,3026,0,400,3428
expose,standard,realAWSCloudwatch/ec2_cpu_utilization_fe7f93.csv,0.9757623691126358,-3.6520437269459967,4,3000,23,401,3428
expose,standard,realAWSCloudwatch/ec2_cpu_utilization_53ea38.csv,0.9757623691126358,-2.0,0,3026,0,402,3428
expose,standard,realAWSCloudwatch/grok_asg_anomaly.csv,0.9757623691126358,0.03899968845370139,2,3459,4,463,3928
expose,standard,realAWSCloudwatch/ec2_disk_write_bytes_1ef3de.csv,0.9757623691126358,-6.926910401492042,8,3473,75,465,4021
expose,standard,realAWSCloudwatch/rds_cpu_utilization_e47b3b.csv,0.9757623691126358,1.4995664849068695,3,3024,2,399,3428
expose,standard,realAWSCloudwatch/ec2_cpu_utilization_77c1ca.csv,0.9757623691126358,-3.3828649897900975,10,2981,44,393,3428
expose,standard,realAWSCloudwatch/elb_request_count_8c0756.csv,0.9757623691126358,-2.0,0,3026,0,402,3428
expose,standard,realAWSCloudwatch/ec2_cpu_utilization_c6585a.csv,0.9757623691126358,0.0,0,3428,0,0,3428
expose,standard,realAWSCloudwatch/ec2_cpu_utilization_5f5533.csv,0.9757623691126358,-0.13844919792440225,1,3026,0,401,3428
expose,standard,realAWSCloudwatch/ec2_cpu_utilization_825cc2.csv,0.9757623691126358,0.39262855318742607,5,3079,6,338,3428
expose,standard,realAWSCloudwatch/ec2_disk_write_bytes_c0d644.csv,0.9757623691126358,-8.096899597272184,16,2938,85,389,3428
Totals,,,,-77.86692739970124,120,298843,504,33375,332842
