Detector,Profile,File,Threshold,Score,TP,TN,FP,FN,Total_Count
expose,reward_low_FN_rate,artificialNoAnomaly/art_flatline.csv,0.9745441124785942,0.0,0,3428,0,0,3428
expose,reward_low_FN_rate,artificialNoAnomaly/art_daily_no_noise.csv,0.9745441124785942,0.0,0,3428,0,0,3428
expose,reward_low_FN_rate,artificialNoAnomaly/art_daily_small_noise.csv,0.9745441124785942,-0.44,0,3424,4,0,3428
expose,reward_low_FN_rate,artificialNoAnomaly/art_noisy.csv,0.9745441124785942,0.0,0,3428,0,0,3428
expose,reward_low_FN_rate,artificialNoAnomaly/art_daily_perfect_square_wave.csv,0.9745441124785942,0.0,0,3428,0,0,3428
expose,reward_low_FN_rate,realKnownCause/nyc_taxi.csv,0.9745441124785942,-10.0,0,8535,0,1035,9570
expose,reward_low_FN_rate,realKnownCause/cpu_utilization_asg_misconfiguration.csv,0.9745441124785942,-3.7555132590935125,5,15758,43,1494,17300
expose,reward_low_FN_rate,realKnownCause/rogue_agent_key_hold.csv,0.9745441124785942,-4.0,0,1410,0,190,1600
expose,reward_low_FN_rate,realKnownCause/ec2_request_latency_system_failure.csv,0.9745441124785942,2.498308132194933,7,3079,3,339,3428
expose,reward_low_FN_rate,realKnownCause/rogue_agent_key_updown.csv,0.9745441124785942,-0.3332258889200158,5,4016,19,525,4565
expose,reward_low_FN_rate,realKnownCause/ambient_temperature_system_failure.csv,0.9745441124785942,-4.0,0,5791,0,726,6517
expose,reward_low_FN_rate,realKnownCause/machine_temperature_system_failure.csv,0.9745441124785942,-5.985194836219234,5,19650,27,2263,21945
expose,reward_low_FN_rate,realTraffic/TravelTime_387.csv,0.9745441124785942,-6.0,0,1876,0,249,2125
expose,reward_low_FN_rate,realTraffic/speed_t4013.csv,0.9745441124785942,0.467302630802113,5,1857,14,245,2121
expose,reward_low_FN_rate,realTraffic/speed_6005.csv,0.9745441124785942,0.8325382014681072,1,1886,0,238,2125
expose,reward_low_FN_rate,realTraffic/TravelTime_451.csv,0.9745441124785942,-2.0,0,1621,0,217,1838
expose,reward_low_FN_rate,realTraffic/occupancy_6005.csv,0.9745441124785942,0.6412724903753929,1,1782,2,238,2023
expose,reward_low_FN_rate,realTraffic/speed_7578.csv,0.9745441124785942,0.27211924016675937,5,838,4,111,958
expose,reward_low_FN_rate,realTraffic/occupancy_t4013.csv,0.9745441124785942,1.2692605576544467,2,1871,4,248,2125
expose,reward_low_FN_rate,realTweets/Twitter_volume_CRM.csv,0.9745441124785942,-1.2363843740884213,6,13523,36,1587,15152
expose,reward_low_FN_rate,realTweets/Twitter_volume_AAPL.csv,0.9745441124785942,-8.11,0,13563,1,1588,15152
expose,reward_low_FN_rate,realTweets/Twitter_volume_IBM.csv,0.9745441124785942,-3.3509259873013852,11,13503,50,1579,15143
expose,reward_low_FN_rate,realTweets/Twitter_volume_CVS.csv,0.9745441124785942,1.9520168602712478,4,13570,7,1522,15103
expose,reward_low_FN_rate,realTweets/Twitter_volume_GOOG.csv,0.9745441124785942,-4.270808413304758,2,13632,28,1430,15092
expose,reward_low_FN_rate,realTweets/Twitter_volume_UPS.csv,0.9745441124785942,-7.005477271839145,29,13424,107,1556,15116
expose,reward_low_FN_rate,realTweets/Twitter_volume_KO.csv,0.9745441124785942,-3.469459302692743,8,13464,50,1579,15101
expose,reward_low_FN_rate,realTweets/Twitter_volume_FB.csv,0.9745441124785942,-0.46194432734443247,4,13483,18,1578,15083
expose,reward_low_FN_rate,realTweets/Twitter_volume_AMZN.csv,0.9745441124785942,-8.0,0,13501,0,1580,15081
expose,reward_low_FN_rate,realTweets/Twitter_volume_PFE.csv,0.9745441124785942,1.1634127784319128,6,13501,19,1582,15108
expose,reward_low_FN_rate,realAdExchange/exchange-2_cpm_results.csv,0.9745441124785942,-4.0,0,1219,0,162,1381
expose,reward_low_FN_rate,realAdExchange/exchange-3_cpm_results.csv,0.9745441124785942,-2.0,0,1155,0,153,1308
expose,reward_low_FN_rate,realAdExchange/exchange-3_cpc_results.csv,0.9745441124785942,-6.0,0,1155,0,153,1308
expose,reward_low_FN_rate,realAdExchange/exchange-4_cpm_results.csv,0.9745441124785942,-2.4835264248766826,3,1231,2,161,1397
expose,reward_low_FN_rate,realAdExchange/exchange-2_cpc_results.csv,0.9745441124785942,-2.0,0,1218,0,163,1381
expose,reward_low_FN_rate,realAdExchange/exchange-4_cpc_results.csv,0.9745441124785942,-6.0,0,1232,0,165,1397
expose,reward_low_FN_rate,artificialWithAnomaly/art_daily_jumpsup.csv,0.9745441124785942,0.41091596571144795,3,3020,5,400,3428
expose,reward_low_FN_rate,artificialWithAnomaly/art_daily_jumpsdown.csv,0.9745441124785942,-0.12430006601565369,2,3015,10,401,3428
expose,reward_low_FN_rate,artificialWithAnomaly/art_daily_flatmiddle.csv,0.9745441124785942,0.2561606643601463,1,3018,7,402,3428
expose,reward_low_FN_rate,artificialWithAnomaly/art_increase_spike_density.csv,0.9745441124785942,-2.0,0,3025,0,403,3428
expose,reward_low_FN_rate,artificialWithAnomaly/art_load_balancer_spikes.csv,0.9745441124785942,-2.0,0,3025,0,403,3428
expose,reward_low_FN_rate,artificialWithAnomaly/art_daily_nojump.csv,0.9745441124785942,-2.588622080513991,0,3018,7,403,3428
expose,reward_low_FN_rate,realAWSCloudwatch/ec2_network_in_257a54.csv,0.9745441124785942,-2.0,0,3025,0,403,3428
expose,reward_low_FN_rate,realAWSCloudwatch/ec2_cpu_utilization_24ae8d.csv,0.9745441124785942,-4.0,0,3026,0,402,3428
expose,reward_low_FN_rate,realAWSCloudwatch/iio_us-east-1_i-a2eb1cd9_NetworkIn.csv,0.9745441124785942,-4.0,0,931,0,126,1057
expose,reward_low_FN_rate,realAWSCloudwatch/ec2_network_in_5abac7.csv,0.9745441124785942,-3.1081119165393307,14,3501,46,460,4021
expose,reward_low_FN_rate,realAWSCloudwatch/ec2_cpu_utilization_ac20cd.csv,0.9745441124785942,0.7673127770158185,2,3024,1,401,3428
expose,reward_low_FN_rate,realAWSCloudwatch/rds_cpu_utilization_cc0c53.csv,0.9745441124785942,-1.1419843171687283,2,3026,0,400,3428
expose,reward_low_FN_rate,realAWSCloudwatch/ec2_cpu_utilization_fe7f93.csv,0.9745441124785942,-4.478345857061789,9,2984,39,396,3428
expose,reward_low_FN_rate,realAWSCloudwatch/ec2_cpu_utilization_53ea38.csv,0.9745441124785942,-4.0,0,3026,0,402,3428
expose,reward_low_FN_rate,realAWSCloudwatch/grok_asg_anomaly.csv,0.9745441124785942,2.0249599029182885,4,3458,5,461,3928
expose,reward_low_FN_rate,realAWSCloudwatch/ec2_disk_write_bytes_1ef3de.csv,0.9745441124785942,-9.765080319834038,15,3447,101,458,4021
expose,reward_low_FN_rate,realAWSCloudwatch/rds_cpu_utilization_e47b3b.csv,0.9745441124785942,1.5031016041511955,5,3024,2,397,3428
expose,reward_low_FN_rate,realAWSCloudwatch/ec2_cpu_utilization_77c1ca.csv,0.9745441124785942,-4.152540422300789,14,2974,51,389,3428
expose,reward_low_FN_rate,realAWSCloudwatch/elb_request_count_8c0756.csv,0.9745441124785942,-4.2174603744535375,0,3024,2,402,3428
expose,reward_low_FN_rate,realAWSCloudwatch/ec2_cpu_utilization_c6585a.csv,0.9745441124785942,0.0,0,3428,0,0,3428
expose,reward_low_FN_rate,realAWSCloudwatch/ec2_cpu_utilization_5f5533.csv,0.9745441124785942,1.7231016041511955,2,3026,0,400,3428
expose,reward_low_FN_rate,realAWSCloudwatch/ec2_cpu_utilization_825cc2.csv,0.9745441124785942,0.39262855318742607,5,3079,6,338,3428
expose,reward_low_FN_rate,realAWSCloudwatch/ec2_disk_write_bytes_c0d644.csv,0.9745441124785942,-12.010611717146048,24,2909,114,381,3428
Totals,,,,-138.31510519385378,211,298513,834,33284,332842
