Detector,Profile,File,Threshold,Score,TP,TN,FP,FN,Total_Count
expose,reward_low_FP_rate,artificialNoAnomaly/art_flatline.csv,0.9773563546478145,0.0,0,3428,0,0,3428
expose,reward_low_FP_rate,artificialNoAnomaly/art_daily_no_noise.csv,0.9773563546478145,0.0,0,3428,0,0,3428
expose,reward_low_FP_rate,artificialNoAnomaly/art_daily_small_noise.csv,0.9773563546478145,0.0,0,3428,0,0,3428
expose,reward_low_FP_rate,artificialNoAnomaly/art_noisy.csv,0.9773563546478145,0.0,0,3428,0,0,3428
expose,reward_low_FP_rate,artificialNoAnomaly/art_daily_perfect_square_wave.csv,0.9773563546478145,0.0,0,3428,0,0,3428
expose,reward_low_FP_rate,realKnownCause/nyc_taxi.csv,0.9773563546478145,-5.0,0,8535,0,1035,9570
expose,reward_low_FP_rate,realKnownCause/cpu_utilization_asg_misconfiguration.csv,0.9773563546478145,-2.5455132590935134,1,15785,16,1498,17300
expose,reward_low_FP_rate,realKnownCause/rogue_agent_key_hold.csv,0.9773563546478145,-2.0,0,1410,0,190,1600
expose,reward_low_FP_rate,realKnownCause/ec2_request_latency_system_failure.csv,0.9773563546478145,-1.8674002326220227,1,3082,0,345,3428
expose,reward_low_FP_rate,realKnownCause/rogue_agent_key_updown.csv,0.9773563546478145,-1.3640583308615306,2,4024,11,528,4565
expose,reward_low_FP_rate,realKnownCause/ambient_temperature_system_failure.csv,0.9773563546478145,-2.0,0,5791,0,726,6517
expose,reward_low_FP_rate,realKnownCause/machine_temperature_system_failure.csv,0.9773563546478145,-4.315317814143796,1,19667,10,2267,21945
expose,reward_low_FP_rate,realTraffic/TravelTime_387.csv,0.9773563546478145,-3.0,0,1876,0,249,2125
expose,reward_low_FP_rate,realTraffic/speed_t4013.csv,0.9773563546478145,1.3524762326610218,3,1868,3,247,2121
expose,reward_low_FP_rate,realTraffic/speed_6005.csv,0.9773563546478145,-1.0,0,1886,0,239,2125
expose,reward_low_FP_rate,realTraffic/TravelTime_451.csv,0.9773563546478145,-1.0,0,1621,0,217,1838
expose,reward_low_FP_rate,realTraffic/occupancy_6005.csv,0.9773563546478145,-1.0,0,1784,0,239,2023
expose,reward_low_FP_rate,realTraffic/speed_7578.csv,0.9773563546478145,-4.0,0,842,0,116,958
expose,reward_low_FP_rate,realTraffic/occupancy_t4013.csv,0.9773563546478145,-2.3761904981697315,0,1873,2,250,2125
expose,reward_low_FP_rate,realTweets/Twitter_volume_CRM.csv,0.9773563546478145,-1.36335766952857,2,13549,10,1591,15152
expose,reward_low_FP_rate,realTweets/Twitter_volume_AAPL.csv,0.9773563546478145,-4.0,0,13564,0,1588,15152
expose,reward_low_FP_rate,realTweets/Twitter_volume_IBM.csv,0.9773563546478145,-2.090392287885968,2,13537,16,1588,15143
expose,reward_low_FP_rate,realTweets/Twitter_volume_CVS.csv,0.9773563546478145,-0.2332132204087226,3,13572,5,1523,15103
expose,reward_low_FP_rate,realTweets/Twitter_volume_GOOG.csv,0.9773563546478145,-3.110023825123821,0,13659,1,1432,15092
expose,reward_low_FP_rate,realTweets/Twitter_volume_UPS.csv,0.9773563546478145,-2.2698781351061355,6,13511,20,1579,15116
expose,reward_low_FP_rate,realTweets/Twitter_volume_KO.csv,0.9773563546478145,-2.267345748584982,1,13512,2,1586,15101
expose,reward_low_FP_rate,realTweets/Twitter_volume_FB.csv,0.9773563546478145,-2.439999782260924,0,13499,2,1582,15083
expose,reward_low_FP_rate,realTweets/Twitter_volume_AMZN.csv,0.9773563546478145,-4.0,0,13501,0,1580,15081
expose,reward_low_FP_rate,realTweets/Twitter_volume_PFE.csv,0.9773563546478145,-1.348934604750437,3,13510,10,1585,15108
expose,reward_low_FP_rate,realAdExchange/exchange-2_cpm_results.csv,0.9773563546478145,-2.0,0,1219,0,162,1381
expose,reward_low_FP_rate,realAdExchange/exchange-3_cpm_results.csv,0.9773563546478145,-1.0,0,1155,0,153,1308
expose,reward_low_FP_rate,realAdExchange/exchange-3_cpc_results.csv,0.9773563546478145,-3.0,0,1155,0,153,1308
expose,reward_low_FP_rate,realAdExchange/exchange-4_cpm_results.csv,0.9773563546478145,-2.351763212438341,2,1232,1,162,1397
expose,reward_low_FP_rate,realAdExchange/exchange-2_cpc_results.csv,0.9773563546478145,-1.0,0,1218,0,163,1381
expose,reward_low_FP_rate,realAdExchange/exchange-4_cpc_results.csv,0.9773563546478145,-3.0,0,1232,0,165,1397
expose,reward_low_FP_rate,artificialWithAnomaly/art_daily_jumpsup.csv,0.9773563546478145,0.7182119928618548,2,3024,1,401,3428
expose,reward_low_FP_rate,artificialWithAnomaly/art_daily_jumpsdown.csv,0.9773563546478145,-1.1400587435686267,0,3024,1,403,3428
expose,reward_low_FP_rate,artificialWithAnomaly/art_daily_flatmiddle.csv,0.9773563546478145,-1.4095650036446996,0,3023,2,403,3428
expose,reward_low_FP_rate,artificialWithAnomaly/art_increase_spike_density.csv,0.9773563546478145,-1.0,0,3025,0,403,3428
expose,reward_low_FP_rate,artificialWithAnomaly/art_load_balancer_spikes.csv,0.9773563546478145,-1.0,0,3025,0,403,3428
expose,reward_low_FP_rate,artificialWithAnomaly/art_daily_nojump.csv,0.9773563546478145,-1.132473569302291,0,3024,1,403,3428
expose,reward_low_FP_rate,realAWSCloudwatch/ec2_network_in_257a54.csv,0.9773563546478145,-1.0,0,3025,0,403,3428
expose,reward_low_FP_rate,realAWSCloudwatch/ec2_cpu_utilization_24ae8d.csv,0.9773563546478145,-2.0,0,3026,0,402,3428
expose,reward_low_FP_rate,realAWSCloudwatch/iio_us-east-1_i-a2eb1cd9_NetworkIn.csv,0.9773563546478145,-2.0,0,931,0,126,1057
expose,reward_low_FP_rate,realAWSCloudwatch/ec2_network_in_5abac7.csv,0.9773563546478145,-1.954431105017958,1,3538,9,473,4021
expose,reward_low_FP_rate,realAWSCloudwatch/ec2_cpu_utilization_ac20cd.csv,0.9773563546478145,0.8589086704377245,1,3025,0,402,3428
expose,reward_low_FP_rate,realAWSCloudwatch/rds_cpu_utilization_cc0c53.csv,0.9773563546478145,-0.14198431716872828,1,3026,0,401,3428
expose,reward_low_FP_rate,realAWSCloudwatch/ec2_cpu_utilization_fe7f93.csv,0.9773563546478145,-4.641433797490573,3,3007,16,402,3428
expose,reward_low_FP_rate,realAWSCloudwatch/ec2_cpu_utilization_53ea38.csv,0.9773563546478145,-2.0,0,3026,0,402,3428
expose,reward_low_FP_rate,realAWSCloudwatch/grok_asg_anomaly.csv,0.9773563546478145,-2.1662830760940537,1,3460,3,464,3928
expose,reward_low_FP_rate,realAWSCloudwatch/ec2_disk_write_bytes_1ef3de.csv,0.9773563546478145,-8.907846702806758,5,3501,47,468,4021
expose,reward_low_FP_rate,realAWSCloudwatch/rds_cpu_utilization_e47b3b.csv,0.9773563546478145,1.2795664849068695,3,3024,2,399,3428
expose,reward_low_FP_rate,realAWSCloudwatch/ec2_cpu_utilization_77c1ca.csv,0.9773563546478145,-3.63065734397106,6,3002,23,397,3428
expose,reward_low_FP_rate,realAWSCloudwatch/elb_request_count_8c0756.csv,0.9773563546478145,-2.0,0,3026,0,402,3428
expose,reward_low_FP_rate,realAWSCloudwatch/ec2_cpu_utilization_c6585a.csv,0.9773563546478145,0.0,0,3428,0,0,3428
expose,reward_low_FP_rate,realAWSCloudwatch/ec2_cpu_utilization_5f5533.csv,0.9773563546478145,-0.13844919792440225,1,3026,0,401,3428
expose,reward_low_FP_rate,realAWSCloudwatch/ec2_cpu_utilization_825cc2.csv,0.9773563546478145,0.29653784028356245,2,3082,3,341,3428
expose,reward_low_FP_rate,realAWSCloudwatch/ec2_disk_write_bytes_c0d644.csv,0.9773563546478145,-9.260156439389185,9,2976,47,396,3428
Totals,,,,-107.9610266962058,62,299083,264,33433,332842
